Target ID	Target consensus
YY1	CAAGATGGCGGC
SREBF2	ATGGGGTGAT
RFX2	CCGCGGTTGCCATGGCAAC
SREBF1	GTGGGGTGAT
HLF	TATTACGTAACC
REST	GGCGCTGTCCATGGTGCTGAA
NFIC	TTGGCA
CTCF	TGGCCACCAGGGGGCGCTA
TLX1::NFIC	TTGGCATGGTGCCA
E2F1	CGGGCGGGAGG
USF2	GGTCACATGAC
CEBPB	ATTGTGCAATA
CDX2	TTTTATGGCTT
JUND(var.2)	GATGACATCATCTTT
TFAP2C	CATGGCCCCAGGGCA
USF1	GGTCACGTGGC
KLF5	GGGGCGGGGC
E2F4	GGGCGGGAAGG
ZBTB33	CAGATCTCGCGAGAG
THAP1	TGCGGGCAG
E2F6	GGGCGGGAAGG
JUN	ATGACATCATCTT
SOX9	GAACAATGG
ZNF354C	GTGGAT
MAX	AAGCACATGG
CEBPA	ATTGCACAATA
SRF	CATGCCCAAATAAGGCAA
RFX5	CTCCCTGGCAACAGC
SP1	GGGGGCGGGGC
TAL1::TCF3	AACAGATGGTCG
PLAG1	GGGGCCCAAGGGGG
INSM1	TGTCAGGGGGCG
SP2	GGGAGGGGGCGGGGC
EGR1	GGCGGGGGCGGGGG
FOXH1	TGTGGATTGGA
BATF::JUN	GAAATGACTCA
NFE2::MAF	ATGACTCAGCAATTT
EBF1	TCCCTGGGGAC
FOSL2	GGATGACTCAT
NRF1	TGCGCAGGCGC
TP53	CATGTCTGGGCATGT
TFAP2A	CATTGCCTCAGGGCA
PBX1	TTTGATTGATGG
ESR1	AGGTCAGGGTGACCTGGGCC
FOXL1	TATGTATA
JUNB	GGATGACTCAT
FOS	AATGAGTCACA
JUN(var.2)	AGGAGATGACTCAT
PPARG	GTAGGTCACGGTGACCTACT
JUND	GATGAGTCACC
ESR2	AGGTCAGGGTGACCT
SMAD2::SMAD3::SMAD4	CTGTCTGTCACCT
RXRA::VDR	TGAACCCGATGACCC
FOSL1	CATGAGTCACC
IRF2	GGAAAGCGAAACCAAAAC
NFYB	CTGATTGGTCCATTT
EHF	CAGGAAGG
MAFK	AAATTGCTGACTCAG
MYC::MAX	GAGCACGTGGT
FOXA1	CAAAGTAAACATGGA
TP63	GGGCATGTCTGGGCATGTCT
ZEB1	CAGGTGAGG
RREB1	TGGGGGGGGGTGGTTTGGGG
NR2C2	AGGGGTCAGAGGTCA
PAX5	GAGGGCAGCCAAGCGTGAC
ESRRA	CCAAGGTCACA
HINFP	GCGGACGTTA
MAFF	AAAAATTGCTGACTCAGC
RELA	GGAAATTCCC
NFYA	AGAGTGCTGATTGGTCCA
SRY	ATTGTTTAC
FOXD1	ATGTTTAC
TEAD1	CGGAGGAATGTG
TCF7L2	AAAGATCAAAGGAA
MEF2C	ATGCTAAAAATAGAA
BRCA1	GTGTTGT
HNF4G	TGGACTTTGGACTCT
MEF2A	AGCTAAAAATAGCAT
ELK4	GCCGGAAGTGG
FLI1	ACAGGAAGTGG
DUX4	TGATTAAATTA
ELK1	GAGCCGGAAG
REL	GGAAATCCCC
NFIL3	TTATGTAACGT
HNF4A	CTGGACTTTGGACTC
RUNX2	GGGGTTTGTGGTTTG
Pax6	TTCACGCATGAGTT
POU2F2	TTCATTTGCATAT
NHLH1	ACGCAGCTGCGC
SPIB	TTCCTCT
FOXC1	TACTTACC
ZNF263	GGAGGAGGAGGGGGAGGAGGA
NFKB1	GGGAATTTCCC
ELF1	GAACCAGGAAGTG
PRDM1	AGAAAGTGAAAGTGA
NR1H2::RXRA	GTTGACCTTTGACCTTT
FOXF2	ATTGTTTACGTTTG
STAT3	CTTCTGGGAAA
EWSR1-FLI1	GGAAGGAAGGAAGGAAGG
NR2F1	AGGTTCAAAGGTCA
IRF1	AAAGTGAAAGTGAAAGTAAAA
STAT2::STAT1	GGAAAATGAAACTGA
GATA3	AGATAAGA
FOXI1	GGATGTTTGTTT
STAT1	TTTCCTGGAAA
NKX3-1	TAAGTAT
FOXP2	AAGTAAACAAA
AR	GAACATTCTGTTCTT
TAL1::GATA1	CTTATCTGTGAGGAGCAG
HSF1	CTTCTAGAAGGTTCT
GATA2	ACAGATAAGAATCT
FOXP1	CAAAAGTAAACAAAG
